11111111
1C0000C1
10111101
1P1E00C1
11111111