1111111111111111111111111111111111
1C000000000000000000000000000000C1
1011111111111111111111111111111101
101000000000000000000000000000C101
1010111111111111111111111111110101
10101C0000000000000000000000C10101
1010101111111111111111111111010101
1010101E00000000000000000000C10101
1010101111111111111111111111110101
10101C000000000000000000000000C101
1010111111111111111111111111111101
1P1C0000000000000000000000000000C1
1111111111111111111111111111111111
